111111111111111111111111111111111111111111111
1000000000000000000000000000000000000000P1111
101111111111111111111J11111111111111111111111
10100000000000000000000000000000000C000000001
101011111111111111111J11111111111111111111101
101010000000000000000000000000000C00000000101
101010111111111111111J11111111111111111110101
1010101000000000000000000000000C0000000010101
101010101111111111111J11111111111111111010101
10101010100000000000000000000C000000001010101
101010101011111111111J11111111111111101010101
101010101010000000000000000C00000000101010101
101010101010111111111J11111111111110101010101
1010101010101000000000000C0000000010101010101
1010101010101011J1111J1111J111111010101010101
10101010101010111111100C000000001010101010101
101010101010101111111011111111101010101010101
101010101010101111111E11111111101010101010101
1010101010101011J1111J1111J111101010101010101
101010101010100000000000000000001010101010101
101010101010111111111J11111111111010101010101
101010101010000000000000000000000010101010101
101010101011111111111J11111111111110101010101
101010101000000000000000000000000000101010101
101010101111111111111J11111111111111101010101
101010100000000000000000000000000000001010101
101010111111111111111J11111111111111111010101
101010000000000000000000000000000000000010101
101011111111111111111J11111111111111111110101
101000000000000000000000000000000000000000101
101111111111111111111J11111111111111111111101
100000000000000000000000000000000000000000001
111111111111111111111111111111111111111111111
