111111111111111111111111111111111111111111111111111111111111111111111111111
100000000000000000000000000000000000000000000000000000000000000000000000P01
101111111111111111111111111111111111111111111111111111111111101111111111111
101000000000000000000000000000000000000000000000000000000000000000000000001
1010000000000000000000000000000000000000000000000000000000000000000000C0001
101000000000000000000000000000000000000000000000000000000000000000000C00001
10100000000000000000000000000000000000000000000000000000000000000000C000001
101000000000000000000000000000000000000000000000000000000000000000000000001
101000000000000000000000000000000000000000000000000000000000000000000000001
101000000000000000000000000000000000000000000000000000000000000000000000001
101000000000000000000000000000000000000000000000000000000000000000000000001
1010000000000000000000000000000000000E0000000000000000000000000000000000001
101000000000000000000000000000000000000000000000000000000000000000000000001
101000000000000000000000000000000000000000000000000000000000000000000000001
101000000000000000000000000000000000000000000000000000000000000000000000001
101000000000000000000000000000000000000000000000000000000000000000000000001
101000000000000000000000000000000000000000000000000000000000000000010000001
101000000000000000000000000000000000000000000000000000000000000000000000001
101000000000000000000000000000000000000000000000000000000000000000000000001
101000000000000000000000000000000000000000000000000000000000000000000000001
100000000000000000000000000000000000000000000000000000000000000000000C00001
111111111111111111111111111111111111111111111111111111111111111111111111111
