111111111111
10000P000001
100C000E0001
111111111111
