111111111111
10000P000S01
100C000E0001
111111111111
